^^....^^^^^^^
^^^...^^^^^^^
^^^....^^^^^^
^^^....^^^^^^
^^^^....^^^^^
^^^^...^^^^^^
^^^^^...^^^^^
^^^^^...^^^^^
^^^^^^...^^^^
^^^^^^...^^^^
^^^^^^^...^^^
^^^^^^^....^^
.............
.............
.............
.............
.............
.....^^......
.....^^......
.....^^......
.............
.............
.............
.............
.............
.............
.............
.............
.............
.............
^^..^^^^^^^^^
.............
.............
.............
.............
.............
.............
.............
.............
.............
.............
.............
.............
.............
.............
.............
.............
.............
.............
.............
^^^^^^^^^^..^
.............
.............
.............
.............
.............
.............
.............
.............
.............
.............
.............
.............
.............
.............
.............
^^..^^^^^^^^^
.............
.............
.............
.............
.............
.............
.............
.............
.............
.............
.............
.............
.............
....^^^^.....
....^^^^.....
....^^^^.....
....^^^^.....
....^^^^.....
.............
^^^^.....^^^^
^^^^.....^^^^
^^^^.....^^^^
^^^^.....^^^^
^^^^.....^^^^
^^^^.....^^^^
^^^^.....^^^^
^^^^.....^^^^
^^^^.....^^^^
.............
.............
.............
.............
.............
......^^^^^^^
....^^^^^^^^^
..^^^^^^^^^^^
..^^^^^^^^^^^
..^^^^^^^^^^^
..^^^^^^^^^^^
..^^^^^^^^^^^
..^^^^^^^^^^^
..^^^^^^^^^^^
..^^^^^^^^^^^
..^^^^^^^^^^^
...^^^^^^^^^^
....^^^^^^^^^
.....^^^^^^^^
......^^^^^^^
.......^^^^^^
........^^^^^
.........^^^^
..........^^^
...........^^
............^
.............
.............
.............
.............
.............
^^^....^^^^^^
^^^^...^^^^^^
^^^^....^^^^^
^^^^^....^^^^
^^^^^...^^^^^
^^^^^...^^^^^
^^^^^^....^^^
^^^^^^....^^^
^^^^^^^...^^^
^^^^^^^....^^
^^^^^^^....^^
............. 
.............
.....^^^.....
.....^^^.....
.....^^......
.............
.............
^^...........
^^...........
^^...........
.............
.............
.............
.............
.....^^^^....
....^^^^^....
...^^^^^^....
...^^^^^^....
....^^^^^....
.....^^^^....
.............
.............
.....^^......
.....^^......
.....^^......
.............
.............
....^^^^^....
....^^^^^....
....^^^^^....
....^^^^^....
.............
.............
^^....^^^^^^^
^^....^^^^^^^
^^^....^^^^^^
^^^....^^^^^^
^^^^....^^^^^
^^^^^....^^^^
^^^^^....^^^^
^^^^^...^^^^^
^^^^^...^^^^^
^^^^^^...^^^^
^^^^^^...^^^^
^^^^^^^...^^^
^^^^^^^...^^^
^^^^^^^....^^
^^^^^^^....^^
.............
.............
.............
.............
.....^^......
.....^^......
.....^^......
.............
.............
.............
.............
.............
.............
.............
.............
.............
.............
^^..^^^^^^^^^
^^..^^^^^^^^^
^^..^^^^^^^^^
^^..^^^^^^^^^
.............
.............
.............
.............
.............
.............
.............
.............
.............
.............
^^..^^^^^^^^^
^^..^^^^^^^^^
^^..^^^^^^^^^
^^..^^^^^^^^^
.............
.............
.............
.............
.............
.............
.............
.............
.............
....^^^^.....
....^^^^.....
....^^^^.....
....^^^^.....
....^^^^.....
....^^^^.....
.............
^^^^.....^^^^
^^^^.....^^^^
^^^^.....^^^^
^^^^.....^^^^
^^^^.....^^^^
^^^^.....^^^^
^^^^.....^^^^
^^^^.....^^^^
^^^^.....^^^^
.............
.............
.............
.............
......^^^^^^^
....^^^^^^^^^
..^^^^^^^^^^^
..^^^^^^^^^^^
..^^^^^^^^^^^
..^^^^^^^^^^^
..^^^^^^^^^^^
..^^^^^^^^^^^
..^^^^^^^^^^^
..^^^^^^^^^^^
...^^^^^^^^^^
....^^^^^^^^^
.....^^^^^^^^
......^^^^^^^
.......^^^^^^
........^^^^^
.........^^^^
.........^^^^
........^^^^^
.......^^^^^^
......^^^^^^^
.....^^^^^^^^
....^^^^^^^^^
...^^^^^^^^^^
...^^^^^^^^^^
....^^^^^^^^^
.....^^^^^^^^
......^^^^^^^
.......^^^^^^
........^^^^^
.........^^^^
..........^^^
...........^^
............^
.............
.............
.............
.............
.............
