^^....^^^^^^^
^^^...^^^^^^^
^^^....^^^^^^
^^^....^^^^^^
^^^^....^^^^^
^^^^...^^^^^^
^^^^^...^^^^^
^^^^^...^^^^^
^^^^^^...^^^^
^^^^^^...^^^^
^^^^^^^...^^^
^^^^^^^....^^
.............
.............
.............
.............
.............
.....^^......
.....^^......
.....^^......
.............
.............
.............
.............
.............
.............
.............
.............
.............
.............
^^..^^^^^^^^^
.............
.............
.............
.............
.............
.............
.............
.............
.............
.............
.............
.............
.............
.............
.............
.............
.............
.............
.............
^^^^^^^^^^..^
.............
.............
.............
.............
.............
.............
.............
.............
.............
.............
.............
.............
.............
.............
.............
^^..^^^^^^^^^
.............
.............
.............
.............
.............
.............
.............
.............
.............
.............
.............
.............
.............
....^^^^.....
....^^^^.....
....^^^^.....
....^^^^.....
....^^^^.....
.............
^^^^.....^^^^
^^^^.....^^^^
^^^^.....^^^^
^^^^.....^^^^
^^^^.....^^^^
^^^^.....^^^^
^^^^.....^^^^
^^^^.....^^^^
^^^^.....^^^^
.............
.............
.............
.............
.............
......^^^^^^^
....^^^^^^^^^
..^^^^^^^^^^^
..^^^^^^^^^^^
..^^^^^^^^^^^
..^^^^^^^^^^^
