.....^^^^^^^^
..^..^^^^^^^^
....^^^^^^^^^
.....^^^^^^^^
^.....^^^^^^^
.^...^^^^^^^^
^....^^^^^^^^
^^....^^^^^^^
^.....^^^^^^^
^....^^^^^^^^
^.....^^^^^^^
.....^^^^^^^^
....^^^^^^^^^
^^....^^^^^^^
^^^.....^^^^^
^^^^^.....^^^
^^^^^^^^....^
^^^^^^^^....^
^^^^^^^^.....
^^^^^^^^.....
^^^^^^^^....^
^^^^^^^^...^^
^^^^^^^^...^^
^^^^^^^^^...^
^^^^^^^^^...^
^^^^^^^....^^
^^^^^^^^^...^
^^^^^^^^^^.^.
^^^^^^^^^..^^
^^^^^^^^....^
^^^^^^^.....^
^^^^^^^.....^
^^^^^^^.....^
^^^^^^^^....^
^^^^^^^^.....
^^^^^^^^.....
^^^^^^^^.....
^^^^^^^^.....
^^^^^^^....^^
^^^^^^^^...^^
^^^^^^^^^....
^^^^^^^^..^..
^^^^^^^^.....
^^^^^^^^....^
^^^^^^^.^.^^^
^^^^^^^..^.^^
^^^^^^...^^^^
^^^^^^^...^^^
^^^^^^^^...^^
^^^^^^^^...^^
^^^^^^^^....^
^^^^^^^^....^
^^^^^^^^...^^
^^^^^^^...^^^
^^^^^^...^^^^
^^^^^^^...^^^
^^^^^^^...^^^
^^^^^...^^^^^
^^^^....^^^^^
^^^...^^^^^^^
^^^...^^^^^^^
^^^^...^^^^^^
^^^^...^^^^^^
^^^...^^^^^^^
^^^....^^^^^^
^^^^...^^^^^^
^^^^^..^.^^^^
^^^^^^.^...^^
^^^^^^^....^^
^^^^^^.....^^
^^^^^^...^.^^
^^^^^^^....^^
^^^^.....^^^^
^^.....^^^^^^
^.....^^^^^^^
^^^.....^^^^^
^^.....^^^^^^
.....^^^^^^^^
....^^^^^^^^^
^^....^^^^^^^
^^^....^^^^^^
^....^^^^^^^^
^....^^^^^^^^
.....^^^^^^^^
....^^^^^^^^^
...^^^^^^^^^^
^....^^^^^^^^
.....^^^^^^^^
.....^^^^^^^^
^^....^^^^^^^
^^^^..^^^^^^^
^^^^^^...^^^^
^^^^...^^^^^^
^^^....^^^^^^
^^^...^^^^^^^
^^^^^^..^^^^^
^^^^^...^^^^^
^^^^.^..^^^^^
^^...^^^^^^^^
^^^....^^^^^^
